11111111111111111111
10000000000000000001
11000010C00010000001
110001C100C010000001
1010000010001000P001
110000000E1000000001
11111111111111111111

