111111111111111111111111
1P1C00000001111C00000001
101000000000001000000001
101000000001101000000001
1000000000C11000000000C1
101C00000011101C000000E1
111C00000001111C000000C1
1C00000000000C1000000001
111111111111111111111111