11111111111111111
111111111C1111111
11P1C000000000111
11010111111110001
11000110000000101
11111110111111101
11CC000000000C1E1
11000111111111111
11111111111111111