1111111111111111111111111111
1P1C0000000001111C0000000001
1010000000000000100000000001
1010000000000110100000000001
100000000000C1100000000000C1
101C0000000011101C00000000E1
111C0000000001111C0000000001
1010000000000000100000000001
1010000000000110100000000001
100000000000C1100000000000C1
101C0000000011101C0000000001
1111111111111111111111111111
1111111111111111111111111111