11111111111111
1P1C0000000001
10101111111101
10001100000001
11111101111111
1C0000000000E1
11111111111111