11111111111111
1P1C0000000001
10100000000001
10100000000001
10000000000001
101C00000000E1
11111111111111