11111111111111
1P1C0000000001
10100000000001
10100000000001
100000000000C1
101C00000000E1
11111111111111