11111111111111
1P1C0000000001
10100000000001
10000000000011
1E1C0000000001
11111111111111