11111111111111
1P1C0000000001
10100000000001
10100000000001
1000E000000011
101C0000000001
11111111111111