111111111111111111111111
1P1C0N000001111C000N0001
101N0N0000000010NCN00N01
101N0N000001101000000N01
1000000000C1100000000NC1
101C00000011101CN00000E1
111C000N0001111C00000NC1
1C000N0C0N000C1000000001
111111111111111111111111