11111111111111111
11111111NC1111111
11P1C000000000111
1101N0111N1110NC1
11000010000000101
11111110111C11001
11CC000000N0000E1
11NNC111111111C01
11111111111111111