11111111111111
1P1C0000000001
10101111N011C1
10001100000CN1
11111101111011
1C00000000ECN1
11111111111111