11111111111111
1P1CNC0N0000N1
101000000000C1
10000000000011
1E1C0N0000N0C1
11111111111111